  ########
  #      ###
  # $$$$   #
  ## # ### #
###        #
#   $$$$ ###
# ### # ##
#   .... #
### .*.. #
  # .... ###
  # ....   #
  ## # ### #
### $$$$   #
#        ###
# ### # ##
#   $$$$ #
###      #
  ########