#########
#  @    #
# $$$   #
#  # #  #
#  #.#  #
#  #.#  #
#   .   #
#########