#######
#     #
#  $  #
#  @  #
#  .  #
#     #
#######