#########
#       #
#  $    #
#  #@   #
#  .    #
#       #
#########