#################
##         ######
#  $     $  #####
# $# #.# #$ #####
#    # #    #####
#  ###.###  #   #
#  . .@. .      #
#  ###.###  #   #
#    # #    #####
# $# #.# #$ #####
#  $     $  #####
##         ######
#################