#########
#   @   #
#  $    #
#  #  . #
#########