##########
#        #
#        #
#    # $ #
#    #   #
##   #####
#        #
#        #
#    @  .#
##########