####     ####
# .#######. #
#.         .#
## ##   ## ##
 # #     # #
 #   #$#   #
 #   $@$   #
 #   #$#   #
 ###     ###
##.## # ##.##
#   $ # $   #
#  ## # ##  #
## #.   .# ##
 # $     $ #
 # ## # ## #
 #         #
 ###########