#########
#  @    #
#  #    #
#  $    #
###.    #
#       #
#########