#########
#  @    #
#  $ #  #
#    #  #
###  #  #
# .  #  #
#    #  #
#########